Name	Color	Barcode
Abbey	Black	GCAGA
Adelaide	Orange	CTTGA
Alana	Black	AGCTA
Arabella	Black	TTGAG
Arianna	Orange	TCCGC
Bobby	Black	CCCAC
Brayden	Black	GCAGT
Bridget	Orange	CGGTT
Bruce	Orange	ACGGA
Byron	Orange	AGCGA
Cali	Orange	TTTTT
Camilla	Orange	ACAGG
Case	Black	GGGAT
Cason	Black	AACTG
Damien	Black	TGCAA
Dania	Black	CATCC
Dereon	Orange	ACACT
Destiney	Orange	CCGTG
Dominik	Black	GGATT
Gabrielle	Orange	CGAAG
Giancarlo	Orange	TATGG
Greta	Black	CCAAC
Israel	Orange	CCTTT
Javion	Orange	TAGCT
Jaylen	Black	TCCGG
Jazlyn	Yellow	AGTGA
Jordyn	Black	CCACC
Jordyna	Yellow	CATAT
Joshua	Black	TACGT
Justus	Black	GTTCA
Kamden	Orange	CCGTA
Karlee	Yellow	GTCGT
Kayla	Yellow	CATAA
Keaton	Green	GCTAA
Kian	Green	GGAAG
Kirsten	Black	TGTGA
Libby	Yellow	AGTCA
Lorelei	Orange	GCGGA
Mariela	Yellow	CGGAG
Martin	Green	CAATT
Mckayla	Green	AGAGT
Mckenzie	Black	GAAAA
Natalia	Green	GATTC
Santiago	Orange	TGTAT
Sarai	Black	CTAGT
Serena	Green	GGTAA
Shelby	Yellow	AAATG
Sienna	Green	GACCT
Terry	Orange	AACCC
Tristian	Black	TGACG
